WE ./sprites/wall2.xpm
NO ./sprites/wall3.xpm
SO ./sprites/wall4.xpm
EA ./sprites/wall1.xpm

C 225,255,255
F 0,0,0

111111111
10N000001
100000001
100000001
100000001
100000001
100000001
100000001
100000001
100000001
100000001
100000001
100000001
100000001
100000001
100000001
100000001
100000001
100000001
100000001
100000001
100000001
100000001
100000001
100000001
100000001
100000001
100000001
100000001
100000001
100000001
100000001
100000001
100000001
100000001
100000001
100000001
100000001
100000001
100000001
100000001
100000001
100000001
100000001
100000001
100000001
100000001
100000001
100000001
100000001
100000001
100000001
100000001
100000001
100000001
100000001
100000001
100000001
100000001
100000001
100000001
100000001
100000001
100000001
100000001
100000001
100000001
100000001
100000001
100000001
100000001
100000001
100000001
100000001
100000001
100000001
100000001
100000001
100000001
100000001
100000001
100000001
100000001
100000001
100000001
100000001
100000001
100000001
100000001
100000001
100000001
100000001
100000001
100000001
100000001
100000001
100000001
100000001
100000001
100000001
100000001
100000001
100000001
100000001
100000001
100000001
100000001
100000001
100000001
100000001
100000001
100000001
100000001
100000001
100000001
100000001
100000001
100000001
100000001
100000001
100000001
100000001
100000001
100000001
100000001
100000001
100000001
100000001
100000001
100000001
100000001
100000001
100000001
100000001
100000001
100000001
100000001
100000001
100000001
100000001
100000001
100000001
100000001
100000001
100000001
100000001
100000001
100000001
100000001
100000001
100000001
100000001
100000001
100000001
100000001
100000001
100000001
100000001
100000001
100000001
100000001
100000001
100000001
100000001
100000001
100000001
100000001
100000001
100000001
100000001
100000001
100000001
100000001
100000001
100000001
100000001
100000001
100000001
100000001
100000001
100000001
100000001
100000001
100000001
100000001
100000001
100000001
100000001
100000001
100000001
100000001
100000001
100000001
100000001
100000001
100000001
100000001
100000001
100000001
100000001
100000001
100000001
100000001
100000001
100000001
100000001
100000001
100000001
100000001
100000001
100000001
100000001
100000001
100000001
100000001
100000001
100000001
100000001
100000001
100000001
100000001
100000001
100000001
100000001
100000001
100000001
100000001
100000001
100000001
100000001
100000001
100000001
100000001
100000001
100000001
100000001
100000001
100000001
100000001
100000001
100000001
100000001
100000001
100000001
100000001
100000001
100000001
100000001
100000001
100000001
100000001
100000001
100000001
100000001
100000001
100000001
100000001
100000001
100000001
100000001
100000001
100000001
100000001
100000001
100000001
100000001
100000001
100000001
100000001
100000001
100000001
100000001
100000001
100000001
100000001
100000001
100000001
100000001
100000001
100000001
100000001
100000001
100000001
100000001
100000001
100000001
100000001
100000001
100000001
100000001
100000001
100000001
100000001
100000001
100000001
100000001
100000001
100000001
100000001
100000001
100000001
100000001
100000001
100000001
100000001
100000001
100000001
100000001
100000001
100000001
100000001
100000001
100000001
100000001
100000001
100000001
100000001
100000001
100000001
100000001
100000001
100000001
100000001
100000001
100000001
100000001
100000001
100000001
100000001
100000001
100000001
100000001
100000001
100000001
100000001
100000001
100000001
100000001
100000001
100000001
100000001
100000001
100000001
100000001
100000001
100000001
100000001
100000001
100000001
100000001
100000001
100000001
100000001
100000001
100000001
100000001
100000001
100000001
100000001
100000001
100000001
100000001
100000001
100000001
100000001
100000001
100000001
100000001
100000001
100000001
100000001
100000001
100000001
100000001
100000001
100000001
100000001
100000001
100000001
100000001
100000001
100000001
100000001
100000001
100000001
100000001
100000001
100000001
100000001
100000001
100000001
100000001
100000001
100000001
100000001
100000001
100000001
100000001
100000001
100000001
100000001
100000001
100000001
100000001
100000001
100000001
100000001
100000001
100000001
100000001
100000001
100000001
100000001
100000001
100000001
100000001
100000001
100000001
100000001
100000001
100000001
100000001
100000001
100000001
100000001
100000001
100000001
100000001
100000001
100000001
100000001
100000001
100000001
100000001
100000001
100000001
100000001
100000001
100000001
100000001
100000001
100000001
100000001
100000001
100000001
100000001
100000001
100000001
100000001
100000001
100000001
100000001
100000001
100000001
100000001
100000001
100000001
100000001
100000001
100000001
100000001
100000001
100000001
100000001
100000001
100000001
100000001
100000001
100000001
100000001
100000001
100000001
100000001
100000001
100000001
100000001
100000001
100000001
100000001
100000001
100000001
100000001
100000001
100000001
100000001
100000001
100000001
100000001
100000001
100000001
100000001
100000001
100000001
100000001
100000001
100000001
100000001
100000001
100000001
100000001
100000001
100000001
100000001
100000001
100000001
100000001
100000001
100000001
100000001
100000001
100000001
100000001
100000001
100000001
100000001
100000001
100000001
100000001
100000001
100000001
100000001
100000001
100000001
100000001
100000001
100000001
100000001
100000001
100000001
100000001
100000001
100000001
100000001
100000001
100000001
100000001
100000001
100000001
100000001
100000001
100000001
100000001
100000001
100000001
100000001
100000001
100000001
100000001
100000001
100000001
100000001
100000001
100000001
100000001
100000001
100000001
100000001
100000001
100000001
100000001
100000001
100000001
100000001
100000001
100000001
100000001
100000001
100000001
100000001
100000001
100000001
100000001
100000001
100000001
100000001
100000001
100000001
100000001
100000001
100000001
100000001
100000001
100000001
100000001
100000001
100000001
100000001
100000001
100000001
100000001
100000001
100000001
100000001
100000001
100000001
100000001
100000001
100000001
100000001
100000001
100000001
100000001
100000001
100000001
100000001
100000001
100000001
100000001
100000001
100000001
100000001
100000001
100000001
100000001
100000001
100000001
100000001
100000001
100000001
100000001
100000001
100000001
100000001
100000001
100000001
100000001
100000001
100000001
100000001
100000001
100000001
100000001
100000001
100000001
100000001
100000001
100000001
100000001
100000001
100000001
100000001
100000001
100000001
100000001
100000001
100000001
100000001
100000001
100000001
100000001
100000001
100000001
100000001
100000001
100000001
100000001
100000001
100000001
100000001
100000001
100000001
100000001
100000001
100000001
100000001
100000001
100000001
100000001
100000001
100000001
100000001
100000001
100000001
100000001
100000001
100000001
100000001
100000001
100000001
100000001
100000001
100000001
100000001
100000001
100000001
100000001
100000001
100000001
100000001
100000001
100000001
100000001
100000001
100000001
100000001
100000001
100000001
100000001
100000001
100000001
100000001
100000001
100000001
100000001
100000001
100000001
100000001
100000001
100000001
100000001
100000001
100000001
100000001
100000001
100000001
100000001
100000001
100000001
100000001
100000001
100000001
100000001
100000001
100000001
100000001
100000001
100000001
100000001
100000001
100000001
100000001
100000001
100000001
100000001
100000001
100000001
100000001
100000001
100000001
100000001
100000001
100000001
100000001
100000001
100000001
100000001
100000001
100000001
100000001
100000001
100000001
100000001
100000001
100000001
100000001
100000001
100000001
100000001
100000001
100000001
100000001
100000001
100000001
100000001
100000001
100000001
100000001
100000001
100000001
100000001
100000001
100000001
100000001
100000001
100000001
100000001
100000001
100000001
100000001
100000001
100000001
100000001
100000001
100000001
100000001
100000001
100000001
100000001
100000001
100000001
100000001
100000001
100000001
111111111