11111111
10100001
10110001
10000001
10N00001
11111111