11111111
10100001
10110001
10000001
1000N001
11111111