NO ./wall.xpm
SO ./wall.xpm
WE ./enemy.xpm
EA ./enemy.xpm
F 125,200,100
C 140,125,100

11111111
10000001
10010001
100N0101
10000001
11111111