NO ./wall.xpm
SO ./wall.xpm
WE ./enemy.xpm
EA ./enemy.xpm
F 0,200,255
C 225,0,255

11111111
10000001
10010001
10000101
10N00001
11111111