11111111
10100001
10110001
10000001
10000N01
11111111