EA ./sprites/east_wall.xpm
C 0,0,0
SO ./sprites/south_wall.xpm
WE ./sprites/wall.xpm
F 225,255,255
NO ./sprites/north_wall.xpm

111

11111111
1000E001
10010001
10000101
10000001
11111111