EA ./sprites/east_wall.xpm
C 0,0,0
SO ./sprites/south_wall.xpm
WE ./sprites/wall.xpm
F 225,255,255
NO ./sprites/north_wall.xpm

121
11111111
10000001
10010001
10000101
1N000001
11111111