WE      ./sprites/wall.xpm
F         125,200,100
SO      ./sprites/south_wall.xpm

EA                   ./sprites/east_wall.xpm
C              140,130,100

NO          ./sprites/north_wall.xpm 
 
 11111111111111111111111111111111111111
100000000000000000000000000000000000011
1000000000000000000000000000000000000001
1000000000000000001010000000000000000001
1000000000000000001010000000000000000001
1000000000000000001N10010000000000000001
1000000000000000001110010000000000000001
1000000000000000000000000000000000000001
1000000000000000000000000000000000000001
1000000000000000000000000000000000000001
1000000000000000000000000000000000000001
1000000000000000000000000000000000000001
 11111111111111111111111111111111111111