WE ./sprites/wall2.xpm
NO ./sprites/wall2.xpm
SO ./sprites/wall2.xpm
EA ./sprites/wall2.xpm

C 0,0,0
F 123,123,123


11111111111111111111
10000000011110011111
1eeeee10000000000001
1eeeee10001001001101
1111D1111110001001C1
1000000000D0000101D1
10000000011111111011
10000000001N00000001
10000000011111111011
10000000000000000001
1000000000000000000000000000000000000001
1000000000000000000000000000000000000001
1000000000000000000000000000000000000001
1000000000000000000000000000000000000001
100000000HH00000000000000000000000000001
100000000HH00000000000000000000000000001
100000000HH00000000000000000000000000001
100000000HH00000000000000000000000000001
100000000HH00000000000000000000000000001
100000000HH00000000000000000000000000001
100000000HH00000000000000000000000000001
100000000HH00000000000000000000000000001
100000000HH00000000000000000000000000001
100000000HH00000000000000000000000000001
100000000HH00000000000000000000000000001
100000000HH00000000000000000000000000001
100000000HH00000000000000000000000000001
100000000HH00000000000000000000000000001
100000000HH00000000000000000000000000001
100000000HH00000000000000000000000000001
100000000HH00000000000000000000000000001
100000000HH00000000000000000000000000001
100000000HH00000000000000000000000000001
100000000HH00000000000000000000000000001
100000000HH00000000000000000000000000001
100000000HH00000000000000000000000000001
100000000HH00000000000000000000000000001
100000000HH00000000000000000000000000001
100000000HH000000001
10000000000000000001
10000000000000000001
10000000000000000001
10000000000000000001
10000000000000000001
10000000000000000001
100000000000000000P1
11111111111111111111