1111111111111
10000000000N1
1C00000000C01
1111111111111