WE      ./sprites/wall.xpm
F         125,200,100
SO      ./sprites/south_wall.xpm

EA                   ./sprites/east_wall.xpm
C              140,130,100

NO          ./sprites/north_wall.xpm

R 123 123
1111111111
10000000W1
1111111111