EA ./sprites/east_wall.xpm
X 140,130,100
WE ./sprites/wall.xpm
NO ./sprites/north_wall.xpm
SO ./sprites/south_wall.xpm
F 125,200,100

1111111111111
10000000000W1
1111111111111