EA ./sprites/east_wall.xpm
C 140,130,100
WE ./sprites/wall.xpm
NO ./sprites/north_wall.xpm
SO ./sprites/south_wall.xpm
F 125,200,100

1111111111
100000x0W1
1111111111