NO ./sprites/north_wall.xpm
SO ./sprites/wall.xpm
WE ./sprites/wall.xpm
EA ./sprites/wall.xpm
F 125,200,100
C 140,125,100

11111111
10000000
10010001
10000101
1N000001
11111111