


       

SO 	 ./sprites/wall.xpm
WE ./sprites/wall.xpm
EA ./sprites/wall.xpm
C 140,125,100
F   125,200,100

NO               ./sprites/wall.xpm


sad asd

asd  asddas 
as das
asd asdasd

  
		   




   11111111
11110000001111
11110000000001
 111111111111111 
1000000000111101
10010001001  111
11100101001
1N100001001        1111
11111111111