


SO  ./sprites/wall.xpm

    WE ./sprites/wall.xpm
EA ./sprites/wall.xpm
C 140,125,100
F   125,200,100
R 255.200.100













NO          ./sprites/north_wall.xpm

   11111111
11110000001111
 11110000000001
100000000011110
10010001001  111
11100101001
1N100001001        1111
11111111111