


       

SO 	 ./sprites/wall.xpm
WE ./sprites/wall.xpm
EA ./sprites/wall.xpm
C 140,125,100
F   125,200,100

NO               ./sprites/wall.xpm
  
		   




   11111111
11110000001111
11110000000001
 111100001111111 
1000000000111111
10010001001 	   111
10000101001 
1N000001001        1111
111111111110000